15 10 360 0 7
BBBB BBBB BBBB BBBB BBBB BBBB BBBB BBBB BBBB BBBB BBBB BBBB BBBB BBBB BBBB
BBBB YYYY YYYY YYYY YYYY YYYY YYYY YYYY YYYY YYYY YYYY YYYY YYYY YYYY BBBB
BBBB YYYY YGGG GGGG GGGG GGGG GGGG GGGG GGGG GGGG GGGG GGGG GGGG YYYY BBBB
BBBB YYYY GGGG RRRR RRRR RRRR RRRR RRRR RRRR RRRR RRRR RRRR GGGG YYYY BBBB
BBBB YYYY GGGG RRRR RMMM MMMM MMMM MMMM MMMM MMMM MMMM RRRR GGGG YYYY BBBB
BBBB YYYY GGGG RRRR MMMM MMMM MMMM MMMM MMMM MMMM MMMM RRRR GGGG YYYY BBBB
BBBB YYYY GGGG RRRR RRRR RRRR RRRR RRRR RRRR RRRR RRRR RRRG GGGG YYYY BBBB
BBBB YYYY GGGG GGGG GGGG GGGG GGGG GGGG GGGG GGGG GGGG GGGG GGGG YYYY BBBB
BBBB YYYY YYYY YYYY YYYY YYYY YYYY YYYY YYYY YYYY YYYY YYYY YYYY YYYB BBBB
BBBB BBBB BBBB BBBB BBBB BBBB BBBB BBBB BBBB BBBB BBBB BBBB BBBB BBBB BBBB
4,5,Di 14,9,D 1,1,$ 2,2,Ru 3,3,¢ 1,8,$ 13,1,$ 2,2,RGt 7,1,RL 12,7,Cl 11,6,Cl 2,7,Ru 3,6,¢ 12,2,Ru 11,3,¢ 10,4,Di
0,0,P,U 0,9,FA,R 14,0,FA,L 10,5,FFT,M