19 11 360 0 5
BBBB BBBB BBBB BBBB BBBB BBBB BBBB BBBB BBBB BBBB BBBB BBBB BBBB BBBB BBBB BBBB BBBB BBBB BBBB
BBBB YGCR RRRR RRRR RRRR RRRR RRRR RRRR RGRG GGGG GGGG GGGG GGGG GGGG GGGG GGGG GGGG GBGB BBBB
BBBB CCCC CCCC CCCC CCCC CCCC CCCC CCCC CCRR YYYY YYYY YYYY YYYY YYYY YYYY YYYY YYYY YYYY BBBB
BBBB CCCC CCCC CCCC CCCC CCCC CCCC CCCC RRYY YYYY YYYY YYYY YYYY YYYY YYYY YYYY YYYY YYYY BBBB
BBBB CCCC CCCC CCCC CCCC CCCC CCCC CCCC RRRR YYYY YYYY YYYY YYYY YYYY YYYY YYYY YYYY YYYY BBBB
BBBB GGGG GGGG GGGG GGGG GGGG GGGG GGGG RRRR YYYY YYYY YYYY YYYY YYYY YYYY YYYY YYYY YYYY BBBB
BBBB GGGG GGGG GGGG GGGG GGGG GGGG GGGG GRGR RRRR RRRR RRRR RRRR RRRR RRRR RRRR RRRR RRRR BBBB
BBBB GGGG GGGG GGGG GGGG GGGG GGGG GGGG GCGC CCCC CCCC CCCC CCCC CCCC CCCC CCCC CCCC CCCC BBBB
BBBB GGGG GGGG GGGG GGGG GGGG GGGG GGGG CCCC CCCC CCCC CCCC CCCC CCCC CCCC CCCC CCCC CCCC BBBB
BBBB GRYC CCCC CCCC CCCC CCCC CCCC CCCC CYCY YYYY YYYY YYYY YYYY YYYY YYYY YYYY YYYY YCRG BBBB
BBBB BBBB BBBB BBBB BBBB BBBB BBBB BBBB BBBB BBBB BBBB BBBB BBBB BBBB BBBB BBBB BBBB BBBB BBBB
14,7,D 1,9,Di 1,1,Di 17,9,Di 2,8,$ 15,6,$ 16,6,Bo 2,4,$ 10,7,$ 2,6,Bo 17,1,GGt 0,0,RL 17,9,RGt 1,9,RGt 1,1,RGt 12,8,GL
2,2,P,U 2,9,FFT,C 13,9,FA,L 8,6,ST,U

