15 10 360 30
RRRR RRRR RRRR RRRR RRRR RRRR RRRR RRRR RRRR RRRR RRRR RRRR RRRR RRRR RRRR
RRRR GGGG GGGG GGGG GGGG GGGG GGGG GGGG GGGG GGGG GGGG GGGG GGGG GGGG RRRR
RRRR GBGG GBBB BBBB BBBB BBBB BBBB BBBB BBBB BBBB BBBB BBBB BGBB BGGG RRRR
RYRR GGGG BBBB RYYY YYYY YYYY YYYY YYYY YYYY YYYY YYYY YRYY BBBB GGGG YRRR
RRRR GYGG BMBB GYYY BMMM MMMM MMMM MMMM MMMM MMMM MBMM YGYY MBBB YGGG RRRR
RRRR GGGY BBBM YYGY MMBM MMMM MMMM MMMM MMMM MMMM MMMB YYYG BBMB GGYG RRRR
RRRY GGGG BBBB YYRY YYYY YYYY YYYY YYYY YYYY YYYY YYYY YYYR BBBB GGGG RRYR
RRRR GGGB BBGB BBBB BBBB BBBB BBBB BBBB BBBB BBBB BBBB BBBB BBBG GGBG RRRR
RRRR GGGG GGGG GGGG GGGG GGGG GGGG GGGG GGGG GGGG GGGG GGGG GGGG GGGG RRRR
RRRR RRRR RRRR RRRR RRRR RRRR RRRR RRRR RRRR RRRR RRRR RRRR RRRR RRRR RRRR
7,3,BGt 8,6,D 3,6,BL 5,4,Ru 11,4,Ru 5,7,Ru 11,7,Ru 8,2,Di 8,9,Di 6,3,$ 10,3,$ 6,8,$ 10,8,$ 12,12,Bo 6,5,¢ 10,6,¢ 4,4,Cl
4,10,A,L 13,10,S,R 5,9,GF,U


