15 10 360 0 4
MMYY MMYY MMYY MMYY YYYY YYYY YYYY YYYY YYBB YYBB YYBB BBYM BBYM BBYM BBBB
MMYY MMYY MMYY MMYY MMMM MMYY MMYY MCYY MCYY MCYY MCYB BBYM BBYM BBYM BBBB
MMMM MMMM MMMM YYYY BBBB BBYY YYYY YYYY YYYY YYYY YYYY BBYM BBYM BBYM BBBB
MMMM MMYY MMYY YYYY BBGG BGYM BGYM BGYM BGYM BGYM BGYM BBYM BBYM BBYM BBBB
MMMM MMYY MMYY YYYY YYGG YYGG YYGG YYGG YYYY YYYY YYYY YYYY YYYY YYRR RRRR
MMMM YYYY YYYY YYYY YYYY YYYY YYYY YYGR YYYY YYYY YYYY YYYY YYYY YYRR RRRR
YYCC YYCC YYCC YYCC YYRR YYRR YYRR YYGR RRRR RRRR RRRR RRRR RRYY RRYR RRRR
RYBR RYBR RYBR RYBR RYBR RYBG RYBG RYBG RYBG RYBR RYBR RYBR RYBR RYBR RYBR
RYCC RYCC RYCC RYCC RYCC RYCG GGGG GGGG GGGG RYCC RYCC RYCC RYCC RYCC RYCC
GGGG GGGG GGGG GGGG GGGG GGGG GGGG GGGG GGGG GGGG GGGG GGGG GGGG GGCC GGCC
(8,9)GGt (8,10)D (3,6)GL (10,5)Ru (9,9)Di (12,12)Bo (3,3)$ (10,10)¢ (4,4)Cl
(13,3)A (1,6)S (7,7)YF

