16 11 360 0 5

BBBB BBBB BBBB BBBB BBBB BBBB BBBB BBBB BBBB BBBB BBBB BBBB BBBB BBBB BBBB BBBB BBBB BBBB BBBB
BBBB YGCR RRRR RRRR RRRR RRRR RRRR RRRR RRGG GGGG GGGG GGGG GGGG GGGG GGGG GGGG GGGG GGGG BBBB
BBBB CCCC CCCC CCCC CCCC CCCC CCCC CCCC	CCRR YYYY YYYY YYYY YYYY YYYY YYYY YYYY YYYY YYYY BBBB
BBBB CCCC CCCC CCCC CCCC CCCC CCCC CCCC	RRYY YYYY YYYY YYYY YYYY YYYY YYYY YYYY YYYY YYYY BBBB
BBBB CCCC CCCC CCCC CCCC CCCC CCCC CCCC	RRRR YYYY YYYY YYYY YYYY YYYY YYYY YYYY YYYY YYYY BBBB
BBBB GGGG GGGG GGGG GGGG GGGG GGGG GGGG	RRRR YYYY YYYY YYYY YYYY YYYY YYYY YYYY YYYY YYYY BBBB
BBBB GGGG GGGG GGGG GGGG GGGG GGGG GGGG	GGRR RRRR RRRR RRRR RRRR RRRR RRRR RRRR RRRR RRRR BBBB
BBBB GGGG GGGG GGGG GGGG GGGG GGGG GGGG	GGCC CCCC CCCC CCCC CCCC CCCC CCCC CCCC CCCC CCCC BBBB
BBBB GGGG GGGG GGGG GGGG GGGG GGGG GGGG	CCCC CCCC CCCC CCCC CCCC CCCC CCCC CCCC CCCC CCCC BBBB
BBBB GRYC CCCC CCCC CCCC CCCC CCCC CCCC	CCYY YYYY YYYY YYYY YYYY YYYY YYYY YYYY YYYY YCRG BBBB
BBBB BBBB BBBB BBBB BBBB BBBB BBBB BBBB BBBB BBBB BBBB BBBB BBBB BBBB BBBB BBBB BBBB BBBB BBBB

15,7,D 10,7,RGt 2,8,$ 15,6,$ 12,8,GL 2,4,$ 10,7,$ 5,4,Bo

2,2,P 2,10,FFt 13,10,FA 

