5 5 360 0 6
RRRR RRRR RRRR RRRR RRRR
RRRR RRRB BBBB RRBR RRRR
RRRR BBBB BBBB BBBB RRRR
RRRR RBRR BBBB BRRR RRRR
RRRR RRRR RRRR RRRR RRRR
2,2,ST