15 10 360 0 2
BBBB BBBB BBBB BBBB BBBB CCCC BBBB BBBB BBBB BBBB BBBB BBBB BBBB BBBB BBBB
BBBB BBBB BBBB BBBB CCCC CCCC YYYY YYYY BBBB BBBB BBBB BBBB BBBB BBBB BBBB
BBBB BBBB BBBB CCCC CCCC CCCC YYYY YYYY YYYY YYYY BBBB BBBB BBBB BBBB BBBB
BBBB BBBB CCCC CCCC CCCC CCCC YYYY YYYY YYYY YYYY YYYY YYYY BBBB BBBB BBBB
BBBB CCCC CCCC CCCC CCCC CCMC CYYY YYYY YYYY YYYY YYYY YYYY YYYY YYYY BBYY
BBBB MMMM MMMM MMMM MMMM MMMG GYGG GGGG GGGG GGGG GGGG GGGG GGGG GGGG GGBB
BBBB BBBB MMMM MMMM MMMM MMMM GGGG GGGG GGGG GGGG GGGG GGGG BBBB BBBB BBBB
BBBB BBBB BBBB MMMM MMMM MMMM GGGG GGGG GGGG GGGG BBBB BBBB BBBB BBBB BBBB
BBBB BBBB BBBB BBBB MMMM MMMM GGGG GGGG BBBB BBBB BBBB BBBB BBBB BBBB BBBB
BBBB BBBB BBBB BBBB BBBB MMMM BBBB BBBB BBBB BBBB BBBB BBBB BBBB BBBB BBBB
14,4,¢ 14,4,RGt 14,5,RGt 13,9,RL 0,0,Di 14,0,Di 14,9,Di 5,0,$ 5,9,$ 6,4,D 4,9,Cl 6,0,Cl
0,9,P,U 1,4,FFT,C 1,5,FFT,M 5,4,ST,U 5,0,FA,D