15 10 360 30
CCCC CCCC CCCC CCCC CCRR RRBB BBBB BBBB BBBB BBBB BBBB BBBB BBBB BBBB BBBB
CCCC CCCC CCCC CCCC CCRR RRRR RRRR RRRR RRBB BBBB BBBB BBBB BBBB BBBB BBBB
CCCC CCCC CCCC CCCC RRRR RRYY YYYY YYYY YYYY YYYY YYYY YYYY YYYY YYYY BBBB
CCCC CCCC CCCC CCCC RRYY YYYY YYYY YYYY YYYY YYYY YYYY YYYY YYYY YYYY BBBB
CCGG CCGG CCGG GGGG GGYY GGYY GGYY GGYY GGGG GGGG GGGG GGGG GGGG GGBB BBBB
GGGG GGGG GGGG GGGG GGGG GGGG GGGG GGGG GGGG GGGG GGGG GGGG GGGG GGBB BBBB
MMGG MMGG MMGG MMGG MMMM MMMM MMMM MMMM MMMM MMMM MMMM MMMM MMGG MMGB MMBB
MGRB MGRB MGRB MGRB MGRB MGRB MGRB MGRB MGRB MGRB MGRB MGRB MGRB MGRB MGRB
MGCC MGCC MGCC MGCC MGCC MGCC MGCC MGCC MGCC MGCC MGCC MGCC MGCC MGCC MGCC
CCCC CCCC CCCC CCCC CCCC CCCC CCCC CCCC CCCC CCCC CCCC CCCC CCCC CCCC CCCC
(2,4)BGt (4,3)BGt (1,1)D (9,9)BL (7,10)Ru (6,6)Di (8,4)GGt (13,5)GL
(3,7)A (7,3)S (10,10)F
