15 10 360 0 3
BBGG BBGG BBGG BBGG GGGG GGGG GGGG GGGG GGRR GGRR GGRR RRRR RRRR RRRR RRRR
BBGG BBGG BBGG BBGG BBBB BBGG BBGG BCGG BCGG BCGG BCGR RRRR RRRR RRRR RRRR
BBBB BBBB BBBB GGGG RRRR RRGG GGGG GGGG GGGG GGGG GGGG RRRR RRRR RRRR RRRR
BBBB BBGG BBGG GGGG RRYY RYGB RYGB RYGB RYGB RYGB RYGB RRRR RRRR RRRR RRRR
BBBB BBGG BBGG GGGG GGYY GGYY GGYY GGYY GGGG GGGG GGGG GGGG GGGG GGMM MMMM
BBBB GGGG GGGG GGGG GGGG GGGG GGGG GGGG GGGG GGGG GGGG GGGG GGGG GGMM MMMM
GGCC GGCC GGCC GGCC GGMM GGMM GGMM GGMM MMMM MMMM MMMM MMMM MMGG MMGM MMMM
MGRM MGRM MGRM MGRM MGRM MGRM MGRM MGRM MGRM MGRM MGRM MGRM MGRM MGRM MGRM
MGCC MGCC MGCC MGCC MGCC MGCC MGCC MGCC MGCC MGCC MGCC MGCC MGCC MGCC MGCC
YYYY YYYY YYYY YYYY YYYY YYYY YYYY YYYY YYYY YYYY YYYY YYYY YYYY YYCC YYCC
13,3,RGt 13,2,D 4,7,RL 3,6,Ru 7,7,Di 6,6,Bo 12,6,Bo
3,3,FA,U 12,5,ST,L 0,4,FFT,B 6,4,P,U
