15 10 360 0 1
RRRR RRRR RRRR RRRR RRRR RRRR RRRR RRRR RRRR RRRR RRRR RRRR RRRR RRRR RRRR
RRRR RRRR RRRR RRRR RRRR RRRR RRRR RRRR RRRR RRRR RRRR RRRR RRRR RRRR RRBB
RRRR BBBB BBBB BBBB BBBB BBBB BBBB BBBB BBBB BBBB BBBB BBBB BBBB BBBB BBBB
RRRR BBBB BBBG GGGG GGGG BBGB BBBY YYYY YYYY BBYB BBBC CCCC CCCC BBCB BBBB
RRRR BBBB GGGG GGGG GGGG GGGG YYYY YYYY YYYY YYYY CCCC CCCC CCCC CCCC BBBB
RRRR BBBB GGGG GGGG GGGG GGGG YYYY YYYY YYYY YYYY CCCC CCCC CCCC CCCC BBBB
RRRR BBBB BGBB GGGG GGGG GBBB BYBB YYYY YYYY YBBB BCBB CCCC CCCC CBBB BBBB
RRRR BBBB BBBB BBBB BBBB BBBB BBBB BBBB BBBB BBBB BBBB BBBB BBBB BBBB BBBB
RRRR RRRR RRRR RRRR RRRR RRRR RRRR RRRR RRRR RRRR RRRR RRRR RRRR RRRR BBRR
RRRR RRRR RRRR RRRR RRRR RRRR RRRR RRRR RRRR RRRR RRRR RRRR RRRR RRRR RRRR
1,2,Di 7,8,Ru
5,4,A 4,2,A