10 7 360 0 6
RRRR RRRR RRRR RRRR RRRR RRRR RRRR RRRR RRRR RRRR
RRRR RYYY YYYY YYYY YYYY YYYY YYYY YYYY YRYY RRRR
RRRR YYYY YYYY YYYY YYYY YYYY YYYY YYYY YYYY RRRR
RRRR YYYY YYYY YYYY YYMM YYMM YYYY YYYY YYYY RRRR
RRRR RRRR RRRR RRRR RRRR RRRR RRRR RRRR RRRR RRRR
RRRR MMRM MMMM MMMM MMMM MMMM MMMM MMMM MMMR RRRR
RRRR RMMM MMMM MMMM MMMM MMMM MMMM MMMM MRMM RRRR
4,6,D 1,1,$ 1,5,$ 8,1,Ru 5,3,Cl 4,4,Di 0,6,Cl 0,0,Di 0,0,RGt 9,0,RL
2,2,P,U 9,6,ST,U 8,0,FA,D